4 9 5 6 1 8 2 3 7 
7 2 6 3 4 9 5 8 1 
3 1 8 7 2 5 4 6 9  
5 7 2 8 9 4 3 1 6
6 4 3 5 7 1 8 9 2
1 8 9 2 6 3 7 4 5
8 3 7 9 5 6 1 2 4
2 6 4 1 8 7 9 5 3 
9 5 1 4 3 2 6 7 8