3 2 5 8 6 7 1 9 4 
6 8 1 4 9 5 3 2 7 
7 9 4 3 2 1 5 6 8  
5 3 9 6 1 4 8 7 2  
2 6 8 7 3 9 4 5 1  
4 1 7 5 8 2 6 3 9 
1 5 3 9 7 8 2 4 6 
9 4 2 1 5 6 7 8 3 
8 7 6 2 4 3 9 1 5 