8 3 6 1 4 9 2 7 5
7 9 2 5 8 6 3 1 4
4 5 1 2 3 7 8 9 6
1 8 3 4 7 2 6 5 9
6 7 5 3 9 1 4 2 8
2 4 9 8 6 5 1 3 7
3 1 4 9 5 8 7 6 2
5 2 7 6 1 4 9 8 3
9 6 8 7 2 3 5 4 1